#separator:Tab
#html:false
#deck:Sports Vocabulary
#notetype:Basic (and reversed card)
#tags column:3
to train	trainieren	Sport::Training
to compete	wettkämpfen; konkurrieren	Sport::Wettkampf Olympia::Wettkampf
to practice	üben; trainieren	Sport::Training
coach	Trainer/-in	Sport::Betreuung Olympia::Betreuung
athlete	Athlet/-in; Sportler/-in	Sport::Allgemein Olympia::Allgemein
competition	Wettkampf; Wettbewerb	Sport::Wettkampf Olympia::Wettkampf
to win	gewinnen	Sport::Erfolg Olympia::Medaille
to lose	verlieren	Sport::Wettkampf
champion	Meister/-in; Champion	Olympia::Erfolg
medal	Medaille	Olympia::Medaille
gold medal	Goldmedaille	Olympia::Medaille
silver medal	Silbermedaille	Olympia::Medaille
bronze medal	Bronzemedaille	Olympia::Medaille
to climb	klettern	Klettern::Grundlagen Olympia::Sportklettern
boulder	Bouldern; Boulder	Klettern::Bouldern
lead climbing	Vorstieg; Lead-Klettern	Klettern::Lead Olympia::Sportklettern
speed climbing	Speed-Klettern	Klettern::Speed Olympia::Sportklettern
to belay	sichern	Klettern::Sicherheit
rope	Seil	Klettern::Ausrüstung
harness	Klettergurt	Klettern::Ausrüstung
carabiner	Karabiner	Klettern::Ausrüstung
chalk	Chalk; Magnesia	Klettern::Ausrüstung
climbing shoes	Kletterschuhe	Klettern::Ausrüstung
hold	Griff	Klettern::Grundlagen
foothold	Tritt	Klettern::Grundlagen
crux	Crux; Schlüsselstelle	Klettern::Route
to flash	flashen	Klettern::Erfolg
to send	durchsteigen	Klettern::Erfolg
grade	Schwierigkeitsgrad	Klettern::Route
warm-up	Aufwärmen	Sport::Training Klettern::Training
stretching	Dehnen	Sport::Training
endurance	Ausdauer	Sport::Training Olympia::Ausdauer
strength	Kraft	Sport::Training Klettern::Training
flexibility	Beweglichkeit; Flexibilität	Sport::Training
mental training	Mentaltraining	Klettern::Mentaltraining Olympia::Mentaltraining
focus	Fokus; Konzentration	Klettern::Mentaltraining
fear	Angst	Klettern::Mentaltraining
to overcome	überwinden	Klettern::Mentaltraining
confidence	Selbstvertrauen	Klettern::Mentaltraining
nutrition	Ernährung	Olympia::Ernährung
recovery	Erholung; Regeneration	Sport::Training Olympia::Regeneration
